###########################
#   #  F  ^ #  ^     # %  #
# * #       #   *    #    #
# * #       #        # F   
# * #       #        ##   #
#   #       #         #   #
##D##     ###         #   #
#          $      *   #D###
#                     #   #
#   $   #  ####       #   #
#       # ***      ####   #
#       #######           #
###########################